NO  ./path
EA ./path
SO ./path
WE ./path


F 100,100,100
C 0,0,0

11111111
1P000001
10P0P001
10000001
10001001
1000P101
10001001
1000N001
1P000001
10000001
10000001
10000001
11111111