NO  ./path
EA ./path
SO ./path
WE ./path


F 100,100,100
C 0,0,0

11111111
10000001
1001P101
10N00001
10000001
11111111